www...www...www...www...www...www
wwwwwwwwwwwwwww.wwwwwwwwwwwwwwwww
.................................
.................................
w...............................w
w...............................w
w...............................w
w...............................w
w...............................w
w...............w...............w
w.....w..w..wwww.ww.ww.ww.w.w.w.w
